67 67 67 67 67 67 67 67 67 67 67 67 67 67 67 67 67 67 67 67 67 67 67 67 67 67 67 67 67 67 67 67 67 67 67 67 67 67 67 67 67 67 67 67 67 67 67 67 67 67
67 67 67 67 67 67 67 67 67 67 67 67 67 67 67 67 67 67 67 67 67 67 67 67 67 67 67 67 67 67 67 67 67 67 67 67 67 67 67 67 67 67 67 67 67 67 67 67 67 67
67 67 67 67 67 67 67 67 67 67 67 67 67 67 67 67 67 67 67 67 67 67 67 67 67 67 67 67 67 67 67 67 67 67 67 67 67 67 67 67 67 67 67 67 67 67 67 67 67 67
67 67 67 67 67 67 67 67 71 78 78 78 78 78 78 78 78 72 67 67 67 67 67 71 78 72 67 67 67 67 67 67 67 67 67 67 67 67 67 67 67 67 67 67 67 67 67 67 67 67
67 67 67 67 67 67 67 71 79 66 66 66 66 66 66 66 66 77 78 78 78 78 78 79 66 77 78 78 78 78 78 78 78 78 78 78 72 67 67 67 67 67 67 67 67 67 67 67 67 67
67 67 67 67 67 67 67 75 66 66 82 66 66 88 66 66 66 66 66 66 66 66 66 66 66 66 66 66 66 66 66 66 66 66 66 66 77 78 78 78 78 78 78 72 67 67 67 67 67 67
67 67 67 67 67 71 78 79 66 66 66 66 66 66 89 66 66 66 66 66 66 66 87 66 66 66 66 66 66 66 66 66 66 66 66 66 66 66 66 66 66 66 66 73 67 67 67 67 67 67
67 67 67 67 71 79 66 66 66 66 66 93 66 90 91 88 66 66 66 66 66 66 66 66 66 66 66 66 66 66 66 66 66 66 66 66 66 66 66 66 66 66 66 73 67 67 67 67 67 67 
67 67 67 71 79 66 66 80 66 66 81 66 66 66 66 66 66 66 66 66 66 66 66 66 66 66 66 66 66 66 66 66 66 66 66 66 66 66 66 66 66 66 66 77 78 72 67 67 67 67
67 67 67 75 66 66 66 66 66 66 66 66 66 66 66 66 66 66 66 66 66 66 86 66 66 66 66 66 66 66 66 66 66 66 66 66 66 66 66 66 66 66 66 66 66 73 67 67 67 67
67 67 67 75 66 66 66 66 80 66 66 66 80 66 66 86 66 66 66 66 66 66 66 66 66 66 66 66 66 66 66 66 66 66 66 66 66 66 66 66 66 66 66 66 68 76 67 67 67 67
67 67 67 75 66 66 66 66 66 66 95 66 66 66 66 66 66 66 66 80 66 66 66 66 66 66 66 66 66 66 66 66 66 66 66 66 66 66 66 66 66 66 66 68 76 67 67 67 67 67
67 67 67 74 70 66 66 66 66 66 66 19 20 21 66 66 66 66 66 66 66 66 66 66 66 66 66 66 66 66 66 66 66 66 66 66 66 66 66 66 66 66 66 77 72 67 67 67 67 67
67 67 67 67 75 66 66 66 66 66 66 66 66 66 80 66 66 66 66 66 66 66 66 66 66 66 66 66 66 66 66 66 66 66 66 66 66 66 66 66 66 66 66 66 73 67 67 67 67 67
67 67 67 71 79 66 83 66 66 66 66 66 66 66 66 66 66 66 80 66 66 66 66 66 66 66 66 66 66 66 66 66 66 66 66 66 66 66 66 66 66 66 66 68 76 67 67 67 67 67
67 67 67 75 66 66 66 66 66 66 66 66 66 66 66 66 66 66 66 66 66 66 66 66 66 66 66 66 66 66 66 66 66 66 66 66 66 66 66 66 66 66 66 73 67 67 67 67 67 67
67 67 67 75 66 66 66 66 66 66 66 66 66 66 80 66 66 66 66 66 66 66 66 66 66 66 66 66 66 66 66 66 66 66 66 66 66 66 66 66 66 66 66 77 78 78 78 72 67 67
67 67 67 74 69 70 66 66 66 66 66 66 66 66 66 66 66 66 66 66 66 66 66 66 66 66 66 66 66 66 66 66 66 66 66 66 66 66 66 66 66 66 66 66 66 66 66 73 67 67
67 67 67 67 67 74 70 86 66 66 66 66 66 66 66 66 80 66 66 66 66 66 66 66 66 66 66 66 66 66 66 66 66 66 66 66 66 66 66 66 66 66 66 66 66 66 68 76 67 67 
67 67 67 67 67 67 74 69 69 69 69 70 66 66 66 66 66 66 66 66 66 66 66 66 66 66 66 66 66 66 66 66 66 66 66 66 66 66 66 66 66 66 66 66 66 68 76 67 67 67 
67 67 67 67 67 67 67 67 67 67 67 74 70 66 66 66 66 66 66 66 66 66 66 66 66 66 66 66 66 66 66 66 66 66 66 66 66 66 66 66 66 66 66 66 66 73 67 67 67 67
67 67 67 67 67 67 67 67 67 67 67 67 75 66 66 66 66 66 66 66 66 66 66 66 66 66 66 66 66 66 66 66 66 66 66 66 66 66 66 66 66 66 66 68 69 76 67 67 67 67
67 67 67 67 67 67 67 67 67 67 67 67 75 66 66 66 66 66 66 66 66 66 66 66 66 66 66 66 66 66 66 66 66 66 66 66 66 66 66 66 66 68 69 76 67 67 67 67 67 67
67 67 67 67 67 67 67 67 67 67 71 78 79 66 66 66 66 66 66 66 66 66 66 66 66 66 66 66 66 66 66 66 66 66 66 66 66 66 66 66 66 73 67 67 67 67 67 67 67 67
67 67 67 67 67 67 67 67 67 67 75 66 66 66 66 66 66 66 66 66 66 66 66 66 66 66 66 66 66 66 66 66 66 66 66 66 66 66 66 66 68 76 67 67 67 67 67 67 67 67
67 67 67 67 67 67 67 67 67 67 75 66 66 66 66 66 66 66 66 66 66 66 66 66 66 66 66 66 66 66 66 66 66 66 66 66 66 66 66 66 73 67 67 67 67 67 67 67 67 67
67 67 67 67 67 71 78 78 78 78 79 66 66 66 66 66 66 66 66 66 66 66 66 66 66 66 66 66 66 66 66 66 66 66 66 66 66 66 66 66 77 78 72 67 67 67 67 67 67 67 
67 67 67 67 67 75 66 66 66 66 66 66 66 66 66 66 66 66 66 66 66 66 66 66 66 66 66 66 66 66 66 66 66 66 66 66 66 66 66 66 66 66 73 67 67 67 67 67 67 67 
67 67 67 67 67 75 66 66 66 66 66 66 66 66 66 66 66 66 66 66 66 66 66 66 66 66 66 66 66 66 66 66 66 66 66 66 66 66 66 66 66 66 77 78 78 72 67 67 67 67
67 67 67 67 67 74 69 70 66 66 66 66 66 66 66 66 66 66 66 66 66 66 66 66 66 66 66 66 66 66 66 66 66 66 66 66 66 66 66 66 66 66 66 66 66 73 67 67 67 67
67 67 67 67 67 67 71 79 66 66 66 66 66 66 66 66 66 66 66 66 66 66 66 66 66 66 66 66 66 66 66 66 66 66 66 66 66 66 66 66 66 66 66 66 66 77 78 72 67 67 
67 67 67 67 67 67 74 69 70 66 66 66 66 66 66 66 66 66 66 66 66 66 66 66 66 66 66 66 66 66 66 66 66 66 66 66 66 66 66 66 66 66 66 66 66 66 66 73 67 67 
67 67 67 67 67 67 67 67 75 66 66 66 66 66 66 66 66 66 66 66 66 66 66 66 66 66 66 66 66 66 66 66 66 66 66 66 66 66 66 66 66 66 66 66 66 66 66 73 67 67
67 67 67 67 67 67 67 67 75 66 66 66 66 66 66 66 66 66 66 66 66 66 66 66 66 66 66 66 66 66 66 66 66 66 66 66 66 66 66 66 66 66 66 66 66 66 68 76 67 67
67 67 67 71 78 78 78 78 79 66 66 66 66 66 66 66 66 66 66 66 66 66 66 66 66 66 66 66 66 66 66 66 66 66 66 66 66 66 66 66 66 66 66 66 66 66 73 67 67 67
67 67 67 75 66 66 66 66 66 66 66 66 66 66 66 66 66 66 66 66 66 66 66 66 66 66 66 66 66 66 66 66 66 66 66 66 66 66 66 66 66 66 66 66 66 66 77 72 67 67
67 67 67 75 66 66 66 66 66 66 66 66 66 66 66 66 66 66 66 66 66 66 66 66 66 66 66 66 66 66 66 66 66 66 66 66 66 66 66 66 66 66 66 66 66 66 66 73 67 67
67 67 67 74 69 70 66 66 66 66 66 66 66 66 66 66 66 66 66 66 66 66 66 66 66 66 66 66 66 66 66 66 66 66 66 66 66 66 66 66 66 66 66 66 68 69 69 76 67 67
67 67 67 67 67 75 66 66 66 66 66 66 66 66 66 66 66 66 66 66 66 66 66 66 66 66 66 66 66 66 66 66 66 66 66 66 66 66 66 66 66 66 66 66 73 67 67 67 67 67
67 67 67 67 67 75 66 66 66 66 66 66 66 66 66 66 66 66 66 66 66 66 66 66 66 66 66 66 66 66 66 66 66 66 66 66 66 66 66 66 66 66 66 66 73 67 67 67 67 67
67 71 78 78 78 79 66 66 66 66 66 66 66 66 66 66 66 66 66 66 66 66 66 66 66 66 66 66 66 66 66 66 66 66 66 66 66 66 66 66 66 68 69 69 76 67 67 67 67 67
67 75 66 66 66 66 66 66 66 66 66 66 66 66 66 66 66 66 66 66 66 66 66 66 66 66 66 66 66 66 66 66 66 66 66 66 66 66 66 66 66 73 67 67 67 67 67 67 67 67
67 75 66 66 66 66 66 66 66 66 66 66 66 66 66 66 66 66 66 66 66 66 66 66 66 66 66 66 66 66 66 66 66 66 66 66 66 66 66 66 66 73 67 67 67 67 67 67 67 67
67 74 70 66 66 66 66 66 66 66 66 66 66 66 66 66 66 66 66 66 66 66 66 66 66 66 66 66 66 66 66 66 66 66 66 66 66 66 66 66 66 73 67 67 67 67 67 67 67 67
67 67 74 70 66 66 66 66 66 66 66 66 66 66 66 66 66 66 66 66 66 66 66 66 66 66 66 66 66 66 66 66 66 66 66 66 66 66 66 66 68 76 67 67 67 67 67 67 67 67
67 67 67 75 66 66 66 66 66 66 68 69 69 69 69 70 66 66 66 66 66 66 66 66 66 66 66 66 66 66 68 69 69 70 66 66 66 66 66 68 76 67 67 67 67 67 67 67 67 67
67 67 67 74 69 69 69 69 69 69 76 67 67 67 67 74 69 69 69 69 70 66 66 66 68 69 69 69 69 69 76 67 67 74 69 69 69 69 69 76 67 67 67 67 67 67 67 67 67 67
67 67 67 67 67 67 67 67 67 67 67 67 67 67 67 67 67 67 67 67 74 69 69 69 76 67 67 67 67 67 67 67 67 67 67 67 67 67 67 67 67 67 67 67 67 67 67 67 67 67
67 67 67 67 67 67 67 67 67 67 67 67 67 67 67 67 67 67 67 67 67 67 67 67 67 67 67 67 67 67 67 67 67 67 67 67 67 67 67 67 67 67 67 67 67 67 67 67 67 67
67 67 67 67 67 67 67 67 67 67 67 67 67 67 67 67 67 67 67 67 67 67 67 67 67 67 67 67 67 67 67 67 67 67 67 67 67 67 67 67 67 67 67 67 67 67 67 67 67 67